0 0 0 90 0 0 0 0 0 0 0 90 90 0 0 0 0 0 0 49 0 0 0 0 0 0 0 0 0 0 0 0 0 69 0 69 26 0 0 26 26 0 26 0 0 0 0 0 0 0 0 0 0 0 0 0 0 0 46 69 0 0 69 0 
0 0 0 90 0 0 0 0 0 0 0 90 90 0 49 0 0 0 0 0 0 0 0 0 0 0 0 0 0 0 0 0 0 77 78 78 9 78 9 9 9 9 0 0 0 0 0 0 0 0 0 0 0 0 0 0 0 14 54 14 15 77 78 78 
0 0 0 65 0 0 0 0 0 0 0 90 90 0 0 0 0 0 41 0 0 0 0 0 0 0 0 2 0 0 45 0 0 71 0 0 17 0 28 28 28 0 0 0 0 0 0 0 0 0 0 0 0 0 0 0 0 0 54 0 0 71 6 0 
0 0 0 90 0 0 0 0 0 0 0 90 90 0 0 0 0 0 0 0 0 48 26 26 26 3 47 3 4 26 53 0 70 71 2 0 0 0 63 5 0 19 0 23 0 31 0 0 0 0 0 0 0 0 0 0 0 0 54 0 0 71 0 0 
0 0 0 90 0 0 0 0 0 0 0 90 90 0 0 0 45 0 0 0 0 8 9 9 9 0 55 11 9 9 9 78 78 79 0 0 0 0 47 29 57 19 0 0 14 0 0 0 38 0 0 0 0 0 0 0 0 69 54 1 70 71 0 0 
0 0 0 90 0 0 0 0 0 0 0 65 90 0 0 0 53 48 0 46 23 16 0 0 5 0 55 19 0 0 0 17 2 0 0 0 6 0 55 11 12 0 0 0 0 45 0 0 0 0 0 0 0 0 0 0 69 77 78 78 78 79 0 0 
0 0 0 90 0 0 0 0 0 0 0 65 90 0 0 0 22 14 14 54 15 16 17 0 0 0 55 27 28 28 28 28 28 28 28 28 0 0 55 19 0 17 0 0 0 53 0 0 0 0 0 0 0 0 0 14 15 43 0 0 6 0 0 0 
0 0 0 90 0 0 0 0 0 0 0 65 90 0 0 0 30 0 0 54 85 16 17 0 0 63 55 63 0 0 63 0 0 0 0 0 19 0 55 19 0 0 0 26 0 26 26 39 0 26 0 0 0 0 0 0 0 43 0 0 0 0 0 0 
0 0 0 65 0 0 0 2 0 0 0 90 90 0 0 14 14 22 0 54 0 16 1 0 0 0 55 0 0 0 0 0 0 5 0 62 27 0 55 27 28 0 0 9 9 9 9 9 9 9 0 0 0 0 0 0 0 43 0 0 0 0 0 0 
0 0 0 90 0 0 4 3 4 0 0 90 90 0 45 0 0 30 0 54 2 16 0 0 0 57 55 0 61 0 47 0 58 56 59 0 21 0 55 0 58 19 0 0 17 0 0 0 2 25 0 0 0 0 0 0 0 51 52 52 52 52 52 52 
0 0 0 65 0 4 3 64 3 2 0 90 90 0 53 0 26 30 1 54 23 16 17 0 0 12 12 12 0 20 55 20 20 20 20 20 11 12 12 12 12 0 0 0 0 0 0 0 0 86 87 0 0 0 0 0 0 0 0 0 0 0 0 0 
0 0 0 65 0 0 4 66 1 0 0 90 65 0 14 15 8 9 9 9 9 10 0 0 6 0 0 5 0 0 55 0 57 0 0 62 27 28 28 28 28 0 0 0 0 0 0 0 0 0 0 0 0 0 0 0 0 0 0 0 4 2 0 0 
0 0 0 65 0 0 0 66 0 0 0 90 90 0 0 0 16 17 2 0 0 17 0 0 0 0 0 0 0 0 55 0 56 59 57 58 21 59 59 59 57 19 0 0 60 0 0 0 0 0 0 0 0 0 2 0 0 2 2 3 3 3 4 0 
0 0 0 90 0 0 0 66 0 0 0 65 90 0 0 85 24 25 25 25 0 0 0 0 0 0 0 0 0 12 12 12 12 12 12 12 12 0 20 11 12 0 0 4 68 4 0 40 0 0 23 0 26 2 1 0 4 3 3 3 6 3 3 4 
0 0 0 90 0 0 0 66 0 0 0 65 90 0 0 0 86 87 0 0 43 1 0 0 0 0 0 0 0 0 0 0 0 0 0 0 0 0 47 19 0 0 0 3 68 3 0 0 0 0 9 33 9 33 33 33 33 33 33 34 3 3 3 3 
0 0 0 65 0 0 0 66 0 0 0 90 90 0 0 0 0 0 45 0 43 17 0 0 0 0 5 0 0 0 0 6 0 64 19 0 0 0 55 19 0 0 0 4 68 4 0 0 0 0 0 2 0 6 1 0 6 0 0 42 4 4 3 3 
44 0 0 65 0 0 0 66 2 0 0 90 90 0 0 0 0 26 53 26 43 0 0 0 0 0 28 28 28 28 28 28 0 66 19 0 0 0 55 19 0 0 0 0 68 0 15 0 0 0 0 0 0 0 0 0 0 0 0 42 0 0 4 0 
0 0 0 90 0 0 4 66 3 4 0 90 90 0 0 85 8 9 36 9 37 0 0 28 28 0 0 63 0 0 5 0 0 66 27 28 28 0 55 19 0 0 0 0 68 0 0 0 0 0 0 0 0 0 0 0 0 0 2 42 0 0 0 0 
0 0 0 65 0 4 3 66 3 3 2 90 65 0 0 2 16 2 0 17 0 0 0 46 0 0 0 29 0 59 56 58 0 66 0 59 59 59 55 19 0 0 26 2 68 0 23 0 0 0 0 0 0 0 6 28 28 28 28 50 0 0 0 0 
0 0 72 73 74 1 3 75 3 3 72 73 73 74 2 1 16 17 0 0 0 0 0 54 11 12 12 12 12 12 12 12 0 75 11 12 12 12 12 13 0 0 0 3 76 3 0 0 0 0 0 0 0 0 42 4 0 0 0 7 0 0 0 7 
0 83 80 81 82 83 83 81 83 83 80 81 81 82 83 83 91 0 0 0 0 0 0 54 43 0 0 0 0 0 0 0 0 81 91 0 0 0 0 0 0 0 0 84 84 84 67 0 0 0 0 0 0 0 42 3 3 4 0 0 0 45 0 7 
0 90 90 90 90 90 90 90 90 90 90 90 90 90 90 90 91 0 0 0 0 0 0 54 19 0 0 0 0 0 0 0 0 90 91 0 0 0 0 0 0 0 0 68 68 68 67 0 0 0 0 0 0 1 0 3 3 3 3 4 0 53 0 0 
0 90 90 90 90 90 90 90 90 90 90 90 90 90 90 90 91 0 0 0 0 52 0 54 51 52 52 52 52 0 0 0 0 90 91 0 0 0 0 0 0 0 0 68 68 68 67 0 0 0 0 0 0 0 32 33 33 33 33 33 33 34 0 0 
0 90 90 90 90 90 90 90 90 90 90 90 90 90 90 90 91 0 0 0 0 7 0 54 0 7 0 0 4 43 2 0 0 90 91 0 0 0 0 0 0 0 0 68 68 68 67 0 0 0 0 0 0 0 2 0 0 0 2 6 0 42 0 0 
0 90 90 90 90 90 90 90 90 90 90 90 90 90 90 90 91 0 0 0 0 7 0 54 1 0 44 4 3 43 0 0 0 90 91 0 0 0 0 0 0 0 0 68 68 68 67 0 0 0 0 0 0 0 0 0 0 0 0 0 0 0 84 84 
0 90 90 90 90 90 90 90 90 90 90 90 90 90 90 90 91 0 0 0 0 0 0 35 36 36 0 14 15 43 0 0 89 90 0 0 0 0 0 0 0 0 0 68 68 68 67 0 0 0 0 0 0 0 0 0 0 0 0 0 0 0 68 68 
0 90 90 90 90 90 90 90 90 90 90 90 90 90 90 90 91 0 0 0 0 0 0 43 2 0 0 0 0 43 0 0 0 88 0 0 0 0 0 0 0 0 0 68 68 68 67 0 0 0 0 0 0 0 0 0 0 0 0 0 0 0 68 68 
0 90 90 90 90 90 90 90 90 90 90 90 90 90 90 90 91 0 0 1 0 23 0 43 0 0 0 0 0 43 0 0 0 0 0 0 0 0 0 0 0 0 0 68 68 68 67 0 0 0 0 0 0 0 0 0 0 0 0 0 0 0 68 68 
0 90 90 90 90 90 90 90 90 90 90 90 90 90 90 90 91 0 0 0 0 0 14 51 52 52 0 0 0 43 2 0 0 0 0 0 0 0 0 0 0 0 0 68 68 68 67 0 0 0 0 0 0 0 0 0 0 0 0 0 0 0 92 92 
89 90 90 90 90 90 90 90 90 90 90 90 90 90 90 90 91 0 0 0 0 0 4 3 3 3 4 0 0 43 0 0 0 0 0 0 0 0 0 0 0 0 0 68 68 68 67 0 0 0 0 0 0 0 0 0 0 0 0 0 0 0 0 0 
0 88 90 90 90 90 90 90 90 90 90 90 90 90 90 90 91 0 0 0 0 1 44 4 4 0 0 1 23 43 0 0 0 0 0 0 0 0 0 0 0 0 0 92 92 92 0 0 0 0 0 0 0 0 0 0 0 0 0 0 0 0 0 0 
0 0 88 88 88 90 90 90 90 88 88 88 90 90 88 90 0 0 0 0 0 36 36 0 0 0 35 36 36 37 0 0 0 0 0 0 0 0 0 0 0 0 0 0 0 0 0 0 0 0 0 0 0 0 0 0 0 0 0 0 0 0 0 0 
0 0 0 0 0 90 90 90 88 0 0 0 88 88 0 88 0 0 0 0 0 0 0 0 0 0 43 0 0 0 0 0 0 0 0 0 0 0 0 0 0 0 0 0 0 0 0 0 0 0 0 0 0 0 0 0 0 0 0 0 0 0 0 0 
0 0 0 0 0 88 88 88 0 0 0 0 0 0 0 0 0 0 0 0 0 0 0 0 84 84 67 0 0 0 0 0 0 0 0 0 0 0 0 0 0 0 0 0 0 0 0 0 0 0 0 0 0 0 0 0 0 0 0 0 0 0 0 0 
0 0 0 0 0 0 0 0 0 0 0 0 0 0 0 0 0 0 0 0 0 0 0 0 68 68 67 0 0 0 0 0 0 0 0 0 0 0 0 0 0 0 0 0 0 0 0 0 0 0 0 0 0 0 0 0 0 0 0 0 0 0 0 0 
0 0 0 0 0 0 0 0 0 0 0 0 0 0 0 0 0 0 0 0 0 0 0 0 68 68 67 0 0 0 0 0 0 0 0 0 0 0 0 0 0 0 0 0 0 0 0 0 0 0 0 0 0 0 0 0 0 0 0 0 0 0 0 0 